{
  "0": ")",
  "1": "!",
  "2": "@",
  "3": "#",
  "4": "$",
  "5": "%",
  "6": "^",
  "7": "&",
  "8": "*",
  "9": "(",
  "Esc": "\u001b",
  "F1": "\u001b[23~",
  "F2": "\u001b[24~",
  "F3": "\u001b[25~",
  "F4": "\u001b[26~",
  "F5": "\u001b[28~",
  "F6": "\u001b[29~",
  "F7": "\u001b[31~",
  "F8": "\u001b[32~",
  "F9": "\u001b[33~",
  "F10": "\u001b[34~",
  "F11": "\u001b[23$",
  "F12": "\u001b[24$",
  "`": "~",
  "-": "_",
  "=": "+",
  "q": "Q",
  "w": "W",
  "e": "E",
  "r": "R",
  "t": "T",
  "y": "Y",
  "u": "U",
  "i": "I",
  "o": "O",
  "p": "P",
  "[": "{",
  "]": "}",
  "\\": "|",
  "a": "A",
  "s": "S",
  "d": "D",
  "f": "F",
  "g": "G",
  "h": "H",
  "j": "J",
  "k": "K",
  "l": "L",
  ";": ":",
  "'": "\"",
  "z": "Z",
  "x": "X",
  "c": "C",
  "v": "V",
  "b": "B",
  "n": "N",
  "m": "M",
  ",": "<",
  ".": ">",
  "/": "?"
}